あいちけん	愛知県
あおもりけん	青森県
あきたけん	秋田県
いしかわけん	石川県
いばらきけん	茨城県
いわてけん	岩手県
えひめけん	愛媛県
おおいたけん	大分県
おおさかふ	大阪府
おかやまけん	岡山県
おきなわけん	沖縄県
かがわけん	香川県
かごしまけん	鹿児島県
かながわけん	神奈川県
ぎふけん	岐阜県
きょうとふ	京都府
くまもとけん	熊本県
ぐんまけん	群馬県
こうちけん	高知県
さいたまけん	埼玉県
さがけん	佐賀県
しがけん	滋賀県
しずおかけん	静岡県
しまねけん	島根県
ちばけん	千葉県
とうきょうと	東京都
とくしまけん	徳島県
とちぎけん	栃木県
とっとりけん	鳥取県
とやまけん	富山県
ながさきけん	長崎県
ながのけん	長野県
ならけん	奈良県
にいがたけん	新潟県
ひょうごけん	兵庫県
ひろしまけん	広島県
ふくいけん	福井県
ふくおかけん	福岡県
ふくしまけん	福島県
ほっかいどう	北海道
みえけん	三重県
みやぎけん	宮城県
みやざきけん	宮崎県
やまがたけん	山形県
やまぐちけん	山口県
やまなしけん	山梨県
わかやまけん	和歌山県
